audio_id	sentence
Voice8	त्यसै गरी विश्वको कुनाकुनामा शान्तिको संदेश छरी अमर बन्न पुगेका शान्तिका अग्रदुत गौतम बुद्ध पनि मेरै देशका बासिन्दा हुन्।
Voice9	श्वेतभैरबी केवल बुट्टाका अस्पष्ट रेखाहरू मोटो खाँडीमा बाकी बचेका थिए तर त्यसमा कति आफ्नोपना ।
Voice10	हाम्रो देश स्वर्ग झैँ सुन्दर र चद्रमा झैँ चम्किलो छ।
Voice11	ढोकाको डन्डीको छाया एउटा भुइँमा सोझो, अर्को भित्तामा च्याप्टो र बाङ्गिएको परिरहेको थियो ।
Voice12	घरघरमा बत्ती निभेका छन्‌ ।
Voice13	यो सारा नेपालीहरूले आफ्ना मनमा लागेका कुराहरू अरूलाई बताउने माध्यम भाषाका रूपमा पनि रहेको छ।
Voice14	प्रारम्भमा ग्रामीण जीवनको बाटोमा तै-तै गरेर पाइलो चाल्ने प्रयत्न गर्दा सान्नानीको सहारा नभई हुँदैनथ्यो।
Voice15	लागि सञ्चारका माध्यमले अहम् भूमिका खेलेको छ, पत्रपत्रिकाको अभावमा व्यक्ति तथा राष्ट्रले राजनीति, खेलकुद, कृषि र अन्य कुराहरू थाहा पाउन सक्दैन ।
Voice16	जस्तै –हाम्रो सहर हेटौँडा ।
Voice17	पहिले जो आमाजस्ती भएर मेरो औंलालाई सहारा दिँदै गाउँका आवश्यक वस्तुहरूलाई चिह्नाउँदै हिंड्थी, त्यो पछि-पछि सहचरी भएर गई ।
Voice18	किशोरले कोठामा एकचोटि दृष्टिपात गर्‍यो ।
Voice19	यस प्रविधिको युगमा पुस्तकालय विद्या प्राप्त गर्नकालागि एक सजिलो मार्फत हो।
Voice20	हामी रिस,राग,कपट र छल कहिले गर्दैनौ।
Voice21	आगामी दिनमा बलिस्टिक क्षेप्यास्त्रसहित थप अस्त्रहरू प्राप्त गर्नका लागि प्रयास गरिरहेको छौँ ।
Voice22	निष्पट्ट शान्ति छ शहरमा; झन्‌ जाडोले शान्तिलाई जम्मोठजस्तो डल्लो पारेर अडाइदिएको छ ।
Voice23	पुस्तकालय आज सबै मानिसले पढ्ने गर्छन।
Voice24	यो हाम्रो स्वास्थकोलागि एकदमै खतरनाक बस्तु हो।
Voice25	दूध खान मन लाग्दा म आमासँग माग्थे तर छोएर खन्नथे।
Voice26	बनारसमा म जन्मेँ, त्यहीं हुर्के ।
Voice27	यस दिन गाई र धनको पूजा गर्ने गरिन्छ।
Voice28	त्यो दिन उहाँ दिशाको आविष्कार गरे र त्यसैले हामीले आज दिशा हेर्न सफल भएका छौ।
Voice29	उक्त महत्त्वलाई बुझ्दा बुझ्दै पनि बढ्दो जनसंख्याको कारणले दिन प्रतिदिन जंगलको विनाश भइरहेको पाइन्छ।
Voice30	मन्त्रीहरू र अरू ठूला-ठूला कर्मचारीहरू सरकारी आवासस्थानहरूमा; पसले, जागीरिया, कृषक, गरीब, मध्यवित्तीय तथा धनी व्यक्तिहरू छन् ।
Voice31	हामीले यसमा रहेको अर्थपूर्ण ज्ञानलाई मनले धारण गर्न सक्यो भने लक्ष्य र आकाङ्क्षा प्राप्त गर्न सक्छौ।
Voice32	तिहार हाम्रा चाडहरू मध्येको एक महत्त्वपूर्ण चाड हो।
Voice33	दूबो पनि छ, तर खोइ, त्यो कम्पनीको बगैंचाको संयम यिनीहरूमा ? खोइ, त्यो सुसंस्कृत, सुव्यवस्थित रचना यिनीहरूको ?
Voice34	हामी त्यहाँ गयौं ।
Voice35	हामी वृक्ष वनस्पतिलाई पनि उनीहरूको उपकार सम्झी श्रद्धा गर्छौं।
Voice36	देशको भौतिक अवस्थालाई विपन्नताबाट सम्पन्नतातर्फ, नराम्रो अवस्थाबाट राम्रो अवस्थातर्फ, यथास्थितिबाट उन्नतितर्फ लैजानुलाई देश विकास भनिन्छ।
Voice37	फर्जी बिल बनाएर समेत इन्धनमा आर्थिक अनियमितता हुने गरेको ती कर्मचारीले बताए ।
Voice38	त्यस्ता वर्गहरूका लागि पनि योग्यता, क्षेमता, रुचि र दक्षता अनुसारका तालिम, रोजगार र कामको व्यवस्था गरी तिनको मनोबल बढाएमा तिनले पनि देश-विकासको होस्टेमा हैसे गर्न पुग्दछन् ।
Voice39	हामी नेपाली विर गोर्खाली रगतले हार मान्दैनौ र गौतम बुद्धको शिक्षालाई चारै तर्फ बाढ्छौ।
Voice40	जीवनचक्रमा हरेक व्यक्ति एकपल्ट युवावस्थामा पुग्दछ र ऊ व्यक्तिगत रूपमा कुनै पद वा ओहदामा बसेर वा नबसेरै भए पनि राष्ट्रिय विकासको पुनीत महायज्ञमा सरिक भएकै हुन्छ।
Voice41	यसमा एउटा वायु निवास गर्छ, त्यसो हुनाले गाउँलेहरू मनौती मान्दै यसमा फलामका कीलाहरू गाड्छन्‌ ।
Voice42	यसबारेमा कार्यवाहक नगरप्रमुख प्रविन र प्रमुख प्रशासकीय अधिकृत विनयकुमार सोनु सम्पर्कमा आउन चाहेनन् ।
Voice43	यो कारणले हामी प्रसन्न वा अन्यलाई प्रभाव पार्नको लागि जन्मिएको छैन र हामी कहिल्यै पनि गर्न सक्दैनौं।
Voice44	अनेकौँ मुहानबाट निस्केका पवित्र नदि जस्तै यहाँ अनेकौँ परम्परा र मान्यता छन्।
Voice45	यदि हामीले आफ्नो अधिकार पाएनौ भने काटमार, हडताल आदि सुरु गर्न थाल्छौ तर आफ्नो दायित्व भने पुरा गर्दैनौं।
Voice46	कसैले कारखानामा बेच्छन् त कसैले होटेलमा बेचिदिन्छन् ।
Voice47	अस्ट्रेलियाले एक इरानी व्यवसाय र तीन जना इरानी नागरिकमाथि प्रतिबन्ध लगाएको जनाउँदै उनले कुरा रखे।
Voice48	अनेकौ मन्दिर, गुम्बा, स्तुपा, कलाकृति आदिले पनि मेरो देशलाई सिगारेका छन् र विश्वमै चिनाएका छन्।
Voice49	यस दिन लक्ष्मीलाई खुसी पार्न सकियो भने घरमा सधैँ लक्ष्मीको बास हुन्छ भन्ने विश्वास पनि सबै हिन्दूहरूमा रहेको पाइन्छ।
Voice50	समाज तथा व्यक्तिको उन्नति नहुने भएकाले यस क्षेत्रमा पनि अनुशासनको महत्त्व टडकारोको रुपमा खट्किन्छ, त्यसै गरी सरकारी तथा गैरसरकारी कार्यालयमा पनि जरुरी छ ।
Voice51	राधा कस्ती सरल बालिका जस्ती थिई, उसको गोल-गोल अनुहारमा अझै बालिकाको स्निग्धता बाँकी नै थियो- तर आमा पनि हुन लागेकी थिई अब त्यो ।
Voice52	शरीर स्वस्थ भएपछि मानिसले धेरै काम गर्न सक्छ।
Voice53	बैनी बडो उत्साही बालिका थिई ।
Voice54	जसलाई वास्तविकताको बोध पाउन म बारम्बार हातले छोइरहन्छु र बीचबीचमा जसमा व्यथित हृदयले टाँस्टिन पुग्छु ।
Voice55	आमा त भन्थिन्‌- गाउँको पाठशालामै कौमुदी पढाए भइहाल्थ्यो नि ।
Voice56	भैंसवार ठिटो पछर्वारेया धारमा भैंसीलाई नुहाउन गएको थियो, हामी दुबैले दुईचोटि कोशीको धारलाई पार गर्यौं ।
Voice57	देशको निर्माणमा र उन्नतिमा समाजको ठुलो योगदान रहेको छ भन्ने कुरा प्रत्यक नागरिकले दिलदिमागले बुझ्नुपर्छ।
Voice58	कसैमा पहाड चढ्ने तीव्र चाहना हुन्छ भने कसैलाई पहाड चढ्ने कुरा सुन्ने बित्तिकै ज्वरो आउँछ।
Voice59	धनी मान्छे नै अहिले अगाडि हुन्छन् र बिभिन्न नराम्रा काम गुस दिएर गराउँछन्।
Voice60	नरनारी सबै, बालक, विद्यार्थी, ज्यामी, कामी, आफ्ना-आफ्ना घरमा-सर्वहारा पाटीका सत्तलमा जहाँ मुन्टो घुसार्ने ठाउँ पाए त्यहीं- सबै सुतेका थिए ।
Voice61	परिवार र समाजको समुचित माया र स्नेह नपाएका वा आवश्कताभन्दा बढी माया र स्नेहले पुल्पुलिएका बालकहरू जब युवा बन्छन् तीमध्ये पनि केही विकृति-विसंगतितर्फ लागेका हुन्छन्।
Voice62	बम फ्याँक्दा किशोरले मनमा निस्सङ्ग भएर विश्वास गरेको थियो कि त्यसको यो कार्य अनिवार्य छ ।
Voice63	राधा लाजले भुतुक्क भएकी थिई ।
Voice511	सिँचाइको लागि पनि बर्सा हुनु जरुरी छ।
Voice512	त्यसै कारणले हामीले आफ्नो दायित्वलाई पुरा गर्नुपर्छ।
Voice513	सैनिकले शस्त्रास्त्रले सुसज्जित भएर राष्ट्रिय अखण्डताको पहरेदारको भूमिका निर्वाह गरेका हुन्छन्।
Voice514	पछिल्लो समय पालिकाले तोकआदेशमै दश जनालाई दैनिक ज्यालादारी कर्मचारीको रूपमा नियुक्त गरेको थियो।
Voice515	यस्तो हुन सक्यो भने गाउँका मानिसले बिस्तारै त्यहाँ भएका पुस्तकहरु पढ्न थाल्छन र केहि ज्ञान प्राप्त गर्छन।
Voice516	रुसले इरानलाई दिने सैन्य सहयोग बढ्नेमा अमेरिका र बेलायत सहमत रहेका उनले बताए ।
Voice517	थुनिएपछि उसले सुन्यो कि राधाले छोरो नै पाई ।
Voice518	हामी उनीहरूलाई छिमेकी, मित्र र आफन्तलाई प्रभाव पार्न चाहन्छौं।
Voice519	यसको कारणले हाम्रो देश नदीको गतिमा विकासमा लाग्ला।
Voice520	‘इन्धनमा त मनलाग्दी खर्च छ,’ पालिकाका एक कर्मचारीले भने, ‘पालिकाको सवारी साधनभन्दा आफन्त र नजिकका मान्छेलाई दिइने इन्धन बढी छ ।
Voice521	यो बिरानो घरमा उ पनि चुप लागेर बसिरहन्थी र केही सोध्यो भने आफ्ना ठूला-ठूला आँखा उठाएर हेर्थी ।
Voice522	कस्तो अनुद्धिगन छ उसको मन- एकदम भावनाशून्य भएको छ उसको हृदय- धोइएर, पुछिएर चोखो ।
Voice523	साहोडको भ्याङ जसबाट राम्रा-राम्रा दतिउन काटिन्छन्‌, बकाइनो जो नीमको रूख होइन, पटेर र झाडका जङ्गल जो कोशीका दुवै किनारामा छन्‌।
Voice524	यसको गौरव हामी सबै गौरव हो।
Voice525	हामी नेपालीले आफ्नो ज्ञानले सबैलाई पवित्र बनाउनुपर्छ।
Voice526	आज यो आधुनिक युगमा मानिस आफ्नो स्वार्थ र कमाउनको लागि अरुलाई मार्ने काम गरछन् ।
Voice527	नेपाली सर्वप्रथम पुस्तकालयको निर्माणमा अगाडि बढाउने मान्छे जोन उड हुन्।
Voice528	यस चाडमा गरिने पूजा र हरेक क्रियाकलापले हामीलाई सत्मार्ग लाग्ने प्रेरणा दिन्छन्।
Voice529	हाम्रो देश नेपालमा दश प्रतिशत व्यापारीले पनि राम्ररी कर तिर्दैनन् र यसको परिणाम पनि हामीले नै भोग्ने गर्छौ।
Voice530	कार्तिक कृष्णपक्षको त्रयोदशी तिथिका सुनसान अँधेरी रातमा घन्किएको मेरो चिच्याहाट सुनेर छिमेकीहरूलाई साथ दिइरहेकी एकछिनका लागि बेपत्ता भएकी थिइन।
Voice531	ति बिचरा साँच्चैका अवसर बाट वन्चित र अशिक्षित नारी को त्यहा उपस्थिती हुनेछ / भएको छ ।
Voice532	कति विश्वास र भरको ढुकुटी लिएर मेरा लागि बसिरहेका थिए ती उड्न लागेका राता-काला बुट्टाहरू ।
Voice533	यो ठूलो रूख पाकडको रूख हो ।
Voice534	अनि अङ्ग्रेजी पनि पढ्न थाली- ए. बी. सी. डी.!
Voice535	प्रहरीसेवा र सेनामा त् अनुशासन नभई हुँदैन, तसैले यी क्षेत्रमा अनुशासनको कडाइक साथ पालना गरिन्छ, यी विभिन्न क्षेत्रमा अनुशासनको पालना नहुने हो ।
Voice536	एसियाका दुई ठुलो राष्ट्र भारत र चीनको बिचमा रहेको मेरो देश नेपाल रहेको छ।
Voice537	कहिले पैसा चोरेको कारणले झगडा गर्छन र कहिले उटपटयाङ काम गर्ने गरछन्।
Voice538	तर उ यति सानी थिई कि केके कुरा गर्ने उसँग ?
Voice539	किशोर फेरि एक्लै भयो कोठामा ।
Voice540	उस दिन खास गरी गाई-गोरुका गोबरबाट पहाड जस्तो बनाई त्यसैलाई गोवर्धन पर्वत मानेर पूजा गर्ने गरिन्छ।
Voice541	मेरो देश मेरो लागि गौरव हो किनकि यहाँ बार्है महिना बग्ने खोला-नाला छन् भने शान्तिको चिन्ह गौतम बुद्धको जन्मस्थल हो।
Voice542	संसारका धेरै मानिसहरू निरन्तर पर्वतारोहण गरीरहन्छन।
Voice543	बनारसको पसल यहाँ कहाँ ? मिश्ची, छोहोरा, नरिवलका टुक्रा, राता, हरिया र काला रङ्गका मोटा- मोटा चुराहरू मात्र थिए त्यसको पसलमा ।
Voice544	धनकी देवी लक्ष्मीले कृपा गरिन् भने भइन्छ भन्ने विश्वास सबै हिन्दूहरूमा रहेको छ।
Voice545	जस्तै-प्रिथिवी नारायण शाह,बलभद्र कुँवर आदि।
Voice546	नेपाल गरिब मुलुक हो तर वनमा धनी छ।
Voice547	एक दिन उसले दुलहीलाई भन्यो साँझतिर- राधा !
Voice548	अझै हाम्रो समाजमा हाम्रो राम्रो परम्परा र संस्कृतिलाई भुलेर पराइको संस्कृतिलाई आँखा चिम्लेर पचाउने केही छन्।
Voice549	सरकारले देशलाई हाम्रै पैसाले चलाउँछन्।
Voice550	भ्रस्टाचार समाजको अर्को समस्यो हो।
Voice551	देहातको बिराट्‌ शून्यताको स्वयं एउटा हिस्सा भएर मेरो कलिलो हृदयलाई कनै सान्त्वना दिँदैन ।
Voice552	विश्वमा नेपाललाई चिन्नेले हामी नेपालीलाई पनि चिन्दछ।
Voice553	यस देशलाई सबैले आफ्नो साझा फूलबारी भनेका छन् र सबैले यसको हेरचाह पनि गरेकै छन्।
Voice554	यहाँको यो ह्वाङ्ग खुला विराटतामा जसमा आधारका लागि केही कुरा पाइँदैन- दृष्टिसम्म कहीं अड्किन पाउँदैन, हराइएला जस्तो भय हुन्छ ।
Voice555	“असम्भव भन्ने कुरो मूर्खहरूका शब्दकोशमा मात्र हुन्छ” भन्ने नेपोलियनको भनाइ पृथ्वीनारायणको जीवनमा पनि चरितार्थ भयो।
Voice556	जसमा अनेकानेक रङ्गका फूलका बिरुवाहरू सजाइएका छन्‌, सानो हावामा पनि चञ्चल भएर शिर हल्लाउन थाल्छन्‌ मानौं उत्साहको लहर तिनीहरूमा फैलिन पुगेको छ ।
Voice557	सोह्र मध्ये पाँच वटा ल्वाइड कम्पनिको, एउटा एलजी तथा दश वटा पानासोनिक कम्पनिको छ ।
Voice558	त्यो धारमा धेरै किसिमका माछा पाइन्छन्‌- रोहु, बुहारी, कतला, काँटी, सिंगी, मुंगरी, बामी ।
Voice559	मैले भोलिपल्ट त्यही दिएर उसका प्रति आफ्नो आदर र कृतज्ञता ज्ञापन गर्न चाहेँ ।
Voice560	विलासिताको साधनमा गणना हुने एसी खरिद गर्न पनि नगरपालिकाले अठार लाख रुपैयाँभन्दा बढी खर्च गरेको छ ।
Voice561	इज्जत थुपार्छ यसले हामी सबैको ।
Voice562	लक्ष्मीपूजाकै दिन नेपाली भाषा र साहित्यका शिखर पुरुष लक्ष्मी प्रसाद देवकोटाको पनि जन्मजयन्ती पर्ने भएकोले यस दिन वा यसकै वरपरका दिनमा हाम्रो देश ।
Voice563	म पनि ठूलो हुन्छु- धेरै पढ्छु ।
Voice564	यहाँको वायु पनि त्यस्तै निर्गन्ध, काशीको हावामा नाना किसिमका गन्ध लादिया हुन्थे, नाला-पनालाको गन्ध,
Voice565	उसले विदेशमा पनि कलेजमा पढ्ने विद्यार्थीहरूको एउटा संघ बनाएको थियो जहाँ नाना बिषयमा छलफल हुन्थे- प्रजातन्त्र; मार्क्सवाद; स्वतन्त्रता; समाज र व्यक्ति आदि विषयहरूमा ।
Voice566	अनि एकछिनपछि त्यसै लहडमा सोधेको जस्तो गरी किशोरले भन्यो- तिमीलाई पहिलो सन्तान छोरा कि छोरी, के मन पर्छ !
Voice567	जल-सम्पदाका हिसाबले मेरो देश विश्वकै ब्राजिलपछि दोस्रो जलधानी देश र एसिया महादेशमा पहिलो जलधनी देशका रुपमा चिनिन्छ।
Voice568	धेरैजसो व्यक्तिहरूले पर्वतारोहणमा नयाँ कीर्तिमान कायम गरेर आफ्नो नाम पनि खाँसै राखेकै छन्।
Voice569	यस्ता चलनको कारणले गरिब घरका छोरीहरुको बेहे भइरहेको छैन।
Voice570	हामीहरू कुद्दै पुग्यौं नजरियाकहाँ ।
Voice571	उपत्यकाका राजाका सहयोगमा आएको अंग्रेज सरदार किनलोकलाई उनले सिन्धुलीमाडीमै धूलो चटाएर लखेटिदिए; ।
Voice572	यी हामी सबै नेपालीको प्यारो देश हो र यसलाई हामीले आफ्नो प्राणभन्दा प्यारो ठानेका छौँ।
Voice573	कतिपय त् यसलाई पेसाकै रूपमा पनि अँगालेको पाइन्छ।
Voice574	तर यो प्राय अविकसित गाउँहरुमा गर्ने चलन हो।
Voice575	ती मध्ये एक खतरनाक र अहिले बढी मात्रामा चलिरहेको समस्या लागु पदार्थ हुन्।
Voice576	गङ्गाजीपारिको बालुवाको गन्धले भरिएको विचित्र आत्मीयताको न्यानो लिएर बग्ने बनारसको हावा यहाँ छैन ।
Voice577	पुस्तकालय एक मन्दिरका रुपमा लिइन सकिन्छ किनभने एसले हामीलाई सचाई र सत्य बाटोमा लाउन सक्छ,यदि तिमीले यसमा भएको ज्ञानलाई सही उपयोग गर्यो भने।
Voice578	त्यसैले हामीले गाउँलाई सहरमा परिवर्तन गर्नु छन् भने सरकारी पुस्तकालय बनाउन सरकार संग माग गर्नुपर्छ।
Voice579	यस देशलाई सबैले आफ्नो साझा फूलबारी बनेका छन् र सबैले यसको हेरचाह पनि गरेकै छन्।
Voice580	काजलको आकाशमा एकनाससँग सलमा सितारा झल्केका हेरिदिने कोही छैन ।
Voice581	मानिसले स्वतन्त्रता पाएमा जे पनि गर्न सक्छन्, मानिसले चाहेको हरेक कुरा स्वतन्त्रता पछि पाउन सक्छन्।
Voice582	हत्केलाले मुख र नाकलाई पुछ्दै स्वाँ... स्वाँ गर्दै उसले भनी- म पर्छ्वारेया (पश्चिमपट्टिको) धारमा नुहाइरहेकी थिएँ ।
Voice583	त्यस्तै नेपाली संस्कृति सबै नेपालको समुन्नति चाहने साझा भावना हो।
Voice584	पश्चिमपट्टि एउटा ठूलो धूपीको रूख थियो ।
Voice585	त्यस कारणले हामीले सक्ने काम गरेर देशको अवस्थालाई अझ गतिलो बनाउनुपर्छ।
Voice586	नेपाली संस्कृतिमा केही विकृतिहरू पनि रहेको छ।
Voice587	पुस्तकालयले हाम्रो जीवनलाई अर्थ दिने गर्छन।
Voice588	नेपालमा एक पछि एक वीरहरूको जन्म भएको छ।
Voice589	सो वैवाहिक सम्बन्धमा समस्या बल्झेपछि बनारसका राजपूत अभिमानसिंहकी छोरी नरेन्द्रलक्ष्मीसँग बिहे गरेका थिए।
Voice590	मानिसको जीवनमा सबैभन्दा सुखको क्षण यसको बाल्यकाल नै रहेछ भन्ने कुरा मैले अहिले आएर थाहा पाए।
Voice591	वातावरण सुधार गर्नका लागि क्रियाकलापहरू बढाउन र महत्त्वपूर्ण रूपमा आफ्ना प्रियजनहरूसँग गुणस्तरको समय खर्च गर्छन्।
Voice592	नजरियाको एउटा सानो छाप्रो मात्र थियो ।
Voice593	यदि प्रकृति अनुशासनमा रहेन भने मानवजीवनको अस्तित्व नै संकटमा पर्दछ, प्रकृतिमा पाइने यस्तो अनुशासन मानिसका लागि प्रेरणादायी बनेको छ।
Voice594	यदि आमाले बोलेको नसुनेको भए यो ध्वनिहीन लोकमा त्यसै प्राणान्त हुने थियो ।
Voice595	नेपाली संस्कृतिमा केही विकृतिहरू पनि रहेको छ।
Voice596	यसलाई कम नगरेसम्म जस्तोसुकै व्यवस्था आए पनि र जोसुकैको नेतृत्व भए पनि देश अगाडि बढ्दैन  सामान्य रुपमा भ्रस्टाचार भनेको घुस लेने वा दिने हो।
Voice597	जंगल जंगली जनावर, पक्षीहरूको आरक्षण पनि हो।
Voice598	तृण, तरु, लता, गुल्मी साराका सारा बर्बर, असंयम बाढमा हुर्केका छन्‌ ।
Voice599	उहाँ बाल्यकालमा पढाईमा कमजोर थिए तर उहाँलाई गणित र विज्ञानमा रुची थियो।
Voice600	आधुनिक युगमा पत्रपत्रिकाले खेल्ने भूमिका ज्यादै प्रभावकारी देखिन्छ, अहिले पत्रपत्रिका विना कुनै पनि क्षेत्रको विकास हुन् सम्भव छैन, ।
Voice601	नारी सम्बन्धित अप्रिय घटनाहरु को नब्बे प्रतिशत कारण नारी शिक्षाको कमी र नारी चेतनाको कमीले नै हुन्छ्न।
Voice602	गत वैशाख तिस मा सम्पन्न स्थानीय तहको निर्वाचनवाट निर्वाचित नगरप्रमुख भीमराज यादवमाथि।
Voice603	नेपाली भाषा नेपालको राष्ट्रभाषा हो।
Voice604	गरिब र असहायलाई हेप्ने, नोकर बनाउने सामन्तवादी सोचबाट मुक्त भएको छैन।
Voice605	पढाइ सुरु गरेपछि मैले आफ्नो खेल्ने समयमा कटौती गरी त्यसलाई पढाइमै लगानी गरे।
Voice606	घर फर्किदा- लुगामा धूलो, हिलो, कानमा कनेलको सेतो, पहेँलो फूल, हातमा झाडका पातला सिरकना र अमरबेलीको पहेँलो लहरा।
Voice607	यहाका मनमोहक प्राकृतिक दृश्य हेर्न पाउँदा विदेशी पर्यटकहरुको मन निकै आनन्दित हुन्छ।
Voice608	म जंगलबाट यी फलफूलहरू घरमा ल्याउथे अनि भोलिपल्ट बिद्यालय लिएर जान्थे र आफ्ना साथीहरूलाई दिन्थे।
Voice609	काशीको मुख्य क्रा हो, त्यहाँका ढुङ्गा, पत्थर जो यहाँ आएर मेरो बालक मनमा तीक्ष्ण अनुभवको रूपमा बारम्बार प्रकट।
Voice610	विसर्जन वाक्य त केही भन्नैपर्छ ।
Voice611	युक्रेनविरुद्ध प्रयोग गर्न रुसलाई ड्रोनहरू आपूर्ति गरेको भन्दै अस्ट्रेलियाले एक व्यवसाय र तीनजना इरानी नागरिकलाई प्रतिबन्धको घोषणा गरेको छ ।
Voice612	आज हरेक स्कुलमा पुस्तकालय ।
Voice613	फूलबारीमा सयपत्री, गुलाफ, कमल, कमल,बेली, चमेली, जाई,जुही आदि हुन्छन्।
Voice614	अरू जाडाका रात्रिसरह नै त्यो रात्रि पनि थियो । जीवनको कार्यरतता एकदम थामिएर अडेको मानौं तमाम विश्व स्पन्दनहीन भएको छ ।
Voice615	यस दिन साँझपाखदेखि नै घर, गोठ, जताततै बत्ती बालेर झिलिमिली पारिने हुनाले यस दिनलाई तिहारको महत्त्वपूर्ण दिन मानिन्छ।
Voice616	किनभने बाढी र पहिरोलाई रोक्ने गर्छ।
Voice617	गर्मी र जाडो मौसम पनि नियमनुसार नै आउँछन्।
Voice618	बिहे गरेर जब उसले एउटी सानी केटीलाई घर लिएर आयो, उसलाई लाग्यो, उसलाई म आफ्नो रूपमा ढाल्छु ।
Voice619	भने स्थिति डरलाग्दो गम्भीर हुन् गई मानवजीवन नै अस्तव्यस्त बन्न पुग्दछ, बिद्यार्थी जीवनमा अनुशासनको ज्यादै महत्त्व रहन्छ, अनुशासनईन बिद्यार्थीको ।
Voice620	गोसाईस्थान एउटा बाबाजीको अखडा थियो ।
Voice621	उनले राष्ट्रियताको सुदृढ स्तम्भ उभ्याउँदै नेपाल आमाको छिया-छिया परेको मुहारलाई मुस्कान भरेका हुन् र उनको मलिन अनुहारमा खुसीको प्रकाश छरेका हुन्।
Voice622	यस दिन गोरुका अतिरिक्त खेतीपातीका लागि नभई नहुने हलो, जुवा आदि जस्ता साधनहरूको पनि पूजा गर्ने प्रचलन छ।
Voice623	त्यसै गरी यहाँक वराह क्षेत्र, मुक्तिक्षेत्र र गोसाइँकुण्ड जस्ता ठाउँहरु पवित्र तीर्थस्थल मानिन्छन।
Voice624	करार र दैनिक ज्यालादारीका कर्मचारीको भारका कारण आर्थिक ब्ययभार बेर्होनु परिरहेको पालिकाले इन्धनमा गरेको भुक्तानी अत्याधिक छ ।
Voice625	वासिङ्टन, किभ — अमेरिकाले इरानले रुसका लागि प्रमुख सैन्य सहयोगीका रूपमा भूमिका निर्वाह गरिरहेको दाबी गरेको छ ।
Voice626	उसले भनेको थियो टाउको हल्लाएर- केही खान मन छैन ।
Voice627	जवानीले नछाडेका र बुढ्याइँले नछोएका युवा-युवतीहरूको समुदायले नै देश विकास जस्तो गुरुतर जिम्मेवारीलाई सहजतासाथ वहन गर्न सक्दछ।
Voice628	मन टुहरो हुन्छ, घबडाहटले आमाकहाँ टाँस्सन पुग्छ, त्यो भयभीत बालक ।
Voice629	सरकारले पनि नङ्गा पाखा, डाहामा वृक्षारोपण गरेको छ।
Voice630	तर हत्याका लागि होइन, चेतावनीका लागि कि युवकलाई स्थिति असैध्य हुन लागिरहेको छ ।
Voice631	रूखा, साना-साना जर्घ्व-केश चौंरी गाईको चमरजस्तो कडा र खस्रो थियो जसको टुप्पो सुकेको परालको जस्तो धृमिल पीतवर्णको थियो ।
Voice632	अर्कोतर्फ, ती व्यक्तिहरूले बुझ्नका लागि उनीहरूलाई मात्र उनीहरूको आवश्यकताहरूमा ध्यान केन्द्रित गर्नुपर्छ र हरेक भौतिकवादी ।
Voice633	पहिलो पटकको पराजयले उनलाई हताशा होइन विजयका लागि नयाँ पाठ सिकायो।
Voice634	त्यसैले विविधता बीच सय थरी बाजाबाट पैदा हुने एउटा मनोहर तालसँग पनि तुलना गरिन्छ।
Voice635	निरीह भएर दुब्लो निर्वर्ण अनुहारमा चम्किने केवल दुई चल्षुले यो देहातको विराट्‌ संसारलाई हेर्छ ।
Voice636	उहाँहरुले देशका लागि केही न केही योगदान दिएर गएका हन्।
Voice637	फेरि गाउँको कत्रो प्रशान्त नीरवता ।
Voice638	बाँकी कारणले गर्दा समयमा वर्ष भई खेतीपाती हुने गर्छ।
Voice639	खाजा खानासाथ मलाई लिएर ग्राम दर्शनमा उ हिँडी ।
Voice640	युक्रेनी अधिकारीले पछिल्लो समय आफ्नो भूभागमा आक्रमण गर्न रुसले इरानमा निर्मित ड्रोनहरूको प्रयोग गरिरहेको बताउँदै आएको छ ।
Voice641	निराशा र कुण्ठ जागृत हुन् नदिई दलीय र व्यक्तिगत स्वार्थभन्दा माथि उठी राष्ट्रिय स्वार्थमा उनीहरूलाई प्रयोग गर्दा राष्ट्रको कायापलट नै हुन् गएको छ।
Voice642	मेरो देश विश्वका साना देशहरुमध्ये एउटा हो तापनि यसको नाम विश्वभरि नै फैलिएको छ।
Voice643	पहाड चढ्दा व्यायाम पनि हुने भएकोले पर्वतारोहण गर्नेहरुको शरीर स्वस्थ अनि तन्दुरुस्त बन्न पुग्दछ।
Voice644	राजनीतिमा हिंसाको पूर्णत: त्याग असम्भव छ, त्यसो हुनाले प्रयत्न यसमा मात्रै गर्नुपर्छ कि हिंसा सीमित रहोस्‌ ।
Voice645	त्यसपछि फेरि फलामे ढोका लाग्यो; सिक्री बारमा रगडियो; बाक्लो ताल्चा मारियो; र गोडाको आवाज बिस्तारै चिसो माटोमा विलीन हुँदै गयो ।
Voice646	हामी नेपालीले दुखसुख बाटी हरेकलाई सहयोग गर्छौ र गरिबलाई खान,कपडा,घर आदि गरिदिन्छौ,हामी नेपाली दयालु छौ र परिश्रम गरी हरेक काम गर्छौ।
Voice647	ब्यक्तिको अनिन्द्य सौन्दर्य मेधा र प्रतिभा हो भनी पहिले आफ्नै दिमागमा घुसाउँ!! पहिले नारीले नारीलाई सम्मान गर्न सिकौँ!! ।
Voice648	तथापि, यसलाई ठूलो व्यावसायिक बनाउन र अत्याधिक इच्छाहरु को लागी अधिक र अधिक कमाई को लागी मान्छेले काम मा धेरै समय खर्च गर्दछ र आफ्नो आमाबाबु, पति र बच्चाहरुलाई बेवास्ता गर्छन।
Voice649	फेरि कमिश्नरले बडो कोमल स्वरमा अन्तिम बार सोधे- तिम्रो अन्तिम इच्छा के छ !; केही भन्नु छ?
Voice650	समय मिलाएर पत्रिका पढ्ने बानी बसाउनुपर्छ, दैनिक रूपमा गर्नुपर्ने कामलाई पन्छाएर खालि पत्रिका पढ्नु राम्रो होइन, ।
Voice651	त्यस्तै नेपालको सरकारी व्यवहार चलाइने भएकोले यो नेपालको राष्ट्रभाषाका रूपमा स्थापित भएको हो।
Voice652	हेर हेर, कति दुब्लो भएको छ अङ्ग्रेजी पढ्दा ।
Voice653	न्वारनको नाउँ आमासँग सोध्न्‌ ।
Voice654	पछिल्लो समय रुसले युक्रेनी ऊर्जा पूर्वाधारलाई लक्षित गरी आक्रमण तीव्र पारेको छ ।
Voice655	त्यस कारणले हामीले सक्ने काम गरेर दशको अवस्थालाई अझ गतिलो बनाउनुपर्छ।
Voice656	नाककोरेको साग, कोशीले छाडेर गएको ठाउँमा जमेको पाँक र त्यहाँको दलदल जसमा फुलकाहीका बाब्‌साहेबहरूको हात्ती भास्सिएर मरेको।
Voice657	सामाजिक समस्या यसका ज्ञानले हटाउन सकिन्छ।
Voice658	उस दिन बिहान गाइको पूजा गरिन्छ अनि राति घरघरमा दीपावली गरी धनकी देवी लक्ष्मीको पूजा गरिन्छ।
Voice659	राधा ! तिमीले घरमा लेख्न-पढ्न सिकेको थियो कि थिएन ?
Voice660	हामी नेपालीले कर्म मात्र गर्नुपर्छ, फलको अपेक्षा गर्नु हुँदैन।
Voice661	सिङ्गो प्रकृति नै मेरो स्वागत गर्न तम्तयार त्यही बेला नै थियो।
Voice662	यहाँको दूबोमा यो गाढा चिल्लो हरितिमा छैन, खसो, खैरो, शुष्क हरियोपन मात्र छ ।
Voice663	सबैले सबैको धर्मलाई सम्मान गर्छौं।
Voice664	उसको जीवन जोखिमपूर्ण पनि हुन्छ।
Voice665	हामी कसैलाई पराइ ठान्दैनौ।
Voice666	हो, आमालाई धेरै काम छ, मालमत्ताको राखनधरन गर्नु छ, उहाँलाई फुर्सत छैन ।
Voice667	उसलाई पुलिसले केर्दा या न्याय गोष्ठीमा सोध्दा उसले एकनाससँग भनेको थियो- मैले फ्याँकेको हो बम ।
Voice668	यस्तो कारणले गर्दा हाम्रो घरपरिवार असुरक्षित छन् ।
Voice669	यो कुकुर-तिहार कार्तिक महिनाको कृष्ण पक्षको चतुर्दशी तिथि परेको दिन पर्दछ।
Voice670	सरकारले कर तिराएर हामीलाई ठग्न काम गरिरहेको होइन।
Voice671	उनीहरू घर फर्के; बाटामा राधाले आफ्नी दिदीको कुरा गरी, जसले छोरा पाउँदा राधा पनि थिई ।
Voice672	अझै हाम्रो समाजमा चेलीबेटी बेचबेखन पनि तिब्र गतिमा बढिरहेको छ।
Voice673	आमा हाँस्थिन्‌ छोरीले कनी-कथी गरेर पढेको देख्दा र कहिले-कहिले त्यहीँनिर बसेर उसले पढेको कथा सुन्थिन्‌ ।
Voice674	युगको आवश्यकता र नेपाली माटाको मागबमोजिम नेपाल आमाले जन्माएका त्यस्ता साहसिक वीरहरूमध्ये सर्वाधिक महत्त्वपूर्ण ऐतिहासिक महारथी हुन्-पृथ्वीनारायण शाह।
Voice675	त्यसैले यो दिन तिहार चाडको निकै महत्त्वपूर्ण दिन हो।
Voice676	शहरबाट सञ्चित गरेर ल्याएको कातर हृदयको भय उसको सङ्गतमा बिस्तार-बिस्तार लोप हुन लागेको जस्तो भयो ।
Voice677	हामी नेपाली एकतामा बसेर हरेक काम गर्छौ र सफलता प्राप्त गर्छौ।
Voice678	नेपाललाई छत्तीस वर्णको साझा फूलबारीका रूपमा प्रस्तुत गर्दै सबै जात-वर्णको समान उन्नति र विकास भएमा राष्ट्रियता मजबुत हुने ।
Voice679	मेरो बुबा आमाको मायाको छहारीमा मेरो बाल्यकाल खुबी रमाइलो भएर बित्यो।
Voice680	नेपाली भाषा साहित्यिक दृष्टिले पनि निकै धनी छ।
Voice681	कोशी नदी पनि सोझै तर्छ र जो क्रोधमा आयो भने आँखा देख्दैन र जसदेखि ठूला-ठूला बाघ पनि डराउँछन्‌; इत्यादि इत्यादि ।
Voice682	हामी हाम्रो चाडपर्वमा काग, कुकुर, गाई, गोरु आदिलाई सम्मान गर्छौं।
Voice683	‘दस कुवा बराबर एउटा पोखरी हुन्छ, दस पोखरी बराबर एउटा पुत्र हुन्छ, दस पुत्रहरू बराबर एउटा रुख हुन्छ।
Voice684	मलाई नचाहिँदो कुरामा अड्को तोपेर घरमा कोलाहल मचाउन पटक्कै मन लाग्दैनथ्यो।
Voice685	नागरिकको कर्तव्य देशको हरेक परिस्थितिमा साथ दिनु र आफूले गर्न सक्ने मेहनत गर्नु पनि हो।
Voice686	पर्वतारोहणमै सारा जीवन बिताउने व्यक्तिहरू पनि प्रशस्त भेटिन्छन्।
Voice687	गत फेब्रुअरीदेखि युक्रेनमाथि सैन्य आक्रमण गरिरहेको रुसले इरानलाई अभूतपूर्व तहको सैन्य सहयोग दिइरहेको ।
Voice688	रङ्गै रङ्गको सुन्दर सृष्टि इन्द्रेणी हो।
Voice689	नेपालका प्रमुख समाचारपत्रहरूको बिक्री-वितरण निकै हुने गरेको पाइन्छ।
Voice690	उसले भनी- म पढ्छु दाइ !
Voice691	त्यो जोगीले हाम्रो गाउँको ठिक्क पश्चिम सडकभन्दा दक्खिनको एउटा सानो पोखरीको पूर्वी डिलमा चारवटा फुसका साना-साना चिट्ट परेका घर बनाएको थियो ।
Voice692	बिजुली, खानेपानी, कर आदिका लागि उठाइएको रूपले नै देशका विभिन्न कार्यहरू गरिन्छ।
Voice693	सयभित्र तमाम जात जाति, भाषा भाषी र धर्मावलम्बीहरुका विचार र भावना मिलेका छन्।
Voice694	अझ मानिस त झन् संसारका प्राणीहरू मध्येकै सर्वश्रेष्ठ एवं चेतनशील प्राणी हो; त्यसैले उ कसैका बन्धनमा नरही आफूखुसी खान, बस्न,बोल्न र घुमफिर गर्न रुचाउँछ, ।
Voice695	त्यसै कारणले यदि हामीले कडा नियम र कानुन बनायो भने हाम्रो समाज अगाडि बढ्न सक्छ र सगरमाथा झैँ उच्च नाम कमाउन सक्छ।
Voice696	मनिष आफ्नो स्वार्थको लागि समस्याहरु उत्पन्न गर्छन ।
Voice697	अनुशासन' शब्दले 'सामाजिक, नैतिक, धार्मिक, राजनैतिक आदि नियम-नियमावलीको मर्यादा र सो मर्यादाभित्र रहने काम भन्ने अर्थ बुझाउँछ, ।
Voice698	घरपालुवा जनावरका रूपमा रहेको र घरकै रखवारी गर्न पालिने कुकुरलाई कालका देवता।
Voice699	यी पाँच दिनमा काग-तिहार, कुकुर-तिहार, गाइ-तिहार, गोरु-तिहार, र भाइ-तिहार गरी जम्मा पाँच तिहार चिनिन्छ।
Voice700	अनेकौँ मठ, मन्दिर, गुम्बा, मस्जिद र गिर्जाघर छन्।
Voice701	मेरो देश पुर्व देखि लिएर पश्चिमसम्म स्वतन्त्र छ।
Voice702	तसर्थ आफ्नो देश युवास्रोतलाई निर्माणतर्फ प्रवाहित गर्न राज्यले रोजगारका बाध बढ्ने पर्छ, उनीहरूको उत्साहको धर्म उच्च आत्मबल र मनोबल साँध लाउनै पर्छ।
Voice703	घरका सबै आत्यधिक लाड प्यार पाएर म चाडै नै तङ्ग्रिन थाले अनि सबैका काख काखमा खेल्दै-रमाउँदै टुकुटुकु हिँड्न सक्ने भए।
Voice704	कालगतिको नियमबाट आएन यो; न अकस्मात्‌  नै आयो ।
Voice705	मेरो जीवनमा यो गाँसिन आई ।
Voice706	यो भावना पारस्परिक ‘जिउँदको जन्ती र मार्दाको मलामी’ उखान सार्थक भएको छ।
Voice707	इरानका कारण युक्रेनमा मानिसहरूले ज्यान गुमाइरहेका छन्,’ उनले भने ।
Voice708	आफ्ना कर्तव्यलाई नभुलेर र देशलाई नछलेर आफ्नो जिम्मेवारी समयमा पूरा गर्नुपर्छ।
Voice709	आदि प्रमुख पत्रिकाहरू छन्, यीमध्ये गोरखापत्र नेपालको सबभन्दा पुरानो पत्रिका हो, पत्रपत्रिका पढ्दा धेरै फाइदा हुने भए तापनि हामीले समयको वास्तै नगरी यसमा एकोहोरिएर लाग्दैन, ।
Voice710	त्यसै गरी विविध जाति, वेश र परम्परा उपज नेपाली संस्कृति हो।
Voice711	हामी सबै आजै देखि आफूले गर्ने काम इमानदारी पूर्वक गर्न थालौं र समाजका लागि एउटा उदाहरण बनौं हामी सबै।
Voice712	पुस्तकालयको देश निर्माण र विकासमा एक स्थान ओगटेको छ।
Voice713	त्यस देशको अनुहारमा अधोगतिको चाया देखिन्छ र अवनतीको छाया देखिन्छ।
Voice714	र बालाई जेठो छोरोमाथि बडो आशा थियो ।
Voice715	सर्वप्रथम नेपाली भाषाको व्याकरण लेख्ने विद्वान् एउटा विदेशी नै हुन्।
Voice716	एकाध बर्षमा उहाँ गणित र विज्ञानमा धेरै नै जान्ने भए।
Voice717	वनबाट अनेकौँ जडीबुटीहरू निस्कने गर्छ।
Voice718	हाम्रो समाजमा ‘गाँस छोड्नु,साथ नछोड्नू’ उखान ज्यादै लोकप्रिय छ।
Voice719	हामी निस्वार्थी र धर्मको बाटोमा लाग्ने मानिस हौ।
Voice720	यसै कारणले हरेक बर्ष धरै मानिसहरुको मृत्यु हुन्छ ।
Voice721	यस खेलले दिने स्वाद बेग्लै र अनौठो हुन्छ।
Voice722	सियो, धागो, सिन्दूर बेच्ने बाक्सावाला, हींग र मेवा किन्छौं कि भन्दै हिंड्ने काबुलीवालाहरूका विभिन्न तीव्रता र।
Voice723	बिदाका दिन म गाउँले साथीहरूसँग नजिकेको जंगलमा घुमफिर गर्ने जान्थे।
Voice724	तिनीहरू उनीहरूको वरिपरी मद्दत गर्न प्रयास गर्छन्, आफैलाई धैर्य कार्यमा समावेश गर्दछ।
Voice725	यस दिनलाई हाल तिहार पनि भनिन्छ।
Voice726	भैरहेका छन्‌- ढुङ्गाका घर, ढुङ्गाका सडक, ढुङ्गाका घाटहरू, त्यहाँको जीवनको चारैतिरका दृढ स्थिर प्रस्तर आधार- ढुङ्गा.।
Voice727	साधारण मृत्यु होइन यो, जसमा जीवन बिस्तार-बिस्तार निभ्दै जान्छ, बिलाउँदै-बिलाउँदै जान्छ; कालगतिको सामान्य नियममा बाँधिएको मृत्यु यो होइन ।
Voice728	विश्वमा नेपाललाई चिन्नेले हामी नेपालीलाई पनि चिन्दछ।
Voice729	नारी नुनिला आँसुका धारा खाएर अमृतमय दूध पिलाउन सक्ने नारी सृष्टिका संरक्षक हुन् ।
Voice730	यो हाम्रो राष्ट्रको बिकासको अनुपम धरोहर हो, यसले देशको विकास गर्न सकिन्छ।
Voice731	सम भन्नु पर्दा पर्वतारोहण पनि मानिसले खेल्ने एक रमाइलो खेल नै हो।
Voice732	त्यो काठको खामो- जाट हो ।
Voice733	सानो गृहस्थीमा आइपर्ने सुख-दुःखका कुराभन्दा माथि कहाँ उठ्थ्यो र उनीहरूको विचार !
Voice734	यस्तो व्यक्ति सबैका नजरमा असल ठहरिन्छ, अनुशासनको क्षेत्र ज्यादै फराकिलो पनि छ।
Voice735	यो चाड लक्ष्मीपूजाका नामले पनि निकै प्रसिद्ध छ।
Voice736	ड्रोन उत्पादनमा रुस र इरानबीचको साझेदारी युक्रेन, इरानका छिमेकी तथा अन्तर्राष्ट्रिय समुदायका लागि घातक हुने कर्बीको भनाइ छ ।
Voice737	अनि बडो मेहेनत गर्न थालेकी थिई पढ्नमा ।
Voice738	र घरको कुनामा या आँपको गाछीमुनि उ घोप्टो परेर सुतेर पढ्थी ।
Voice739	यस देशले आफूलाई विश्वमा चिनाउने सामर्थ्य पनि राखेको छ।
Voice740	ठूलो योगदान रहेको छ, अहिलेको युग भनेको प्रतिस्पर्धाको युग हो, आज विश्वमै औद्योगिक विकासको गति तीव्र रूपमा बढिरहेको छ, विभिन्न उद्योगहरूले आफ्ना उत्पादनहरू ।
Voice741	हामी सबैका चाडपर्व एक अर्कामा शुभ कामना व्यक्त गर्छौं।
Voice742	तिनीहरूले उच्च सोच्न वा विस्तृत मानसिकता विकास गर्न सक्दैनन्।
Voice743	स्नेह गरी उनीहरूको धुकधुकीको स्पर्श गरेर नेपाली राष्ट्रियताको मजबुत आधार खडा गरे।
Voice744	त्यसैले यस दिन गाईलाई फुलको माला लगाएर थरथरीका मीठा मीठा खाने कुरा खान दिई गाई पूजा गरिन्छ।
Voice745	नेपालमा भएको जंगलको सदुपयोग गर्न सकेमा नेपाल धनी र नेपाली सुख हुन् सक्छन्।
Voice746	युवा-युवतीहरूका जोस र जाँगरका अगाडि जस्तोसुकै कठिन चुनौतीले पनि शिर निहुराउने पर्छ।
Voice747	यसै दिन कालका देवता यमराज पनि आफ्नी बहिनी यमुना कहाँ टीका लगाउन जाने कथा हिन्दू पुराणमा उल्लेख गरिएको छ।
Voice748	अतः युवाहरूका आट र उत्साहको इन्धन प्राप्त गर्दा देशले विकास मार्गमा आएका जुनसुकै हाँक र बन्धनलाई सजिलै परास्त गर्न सक्छ।
Voice749	यस्तो करा गाउँमा पहिले कहिल्यै पनि भएको थिएन ।
Voice750	यहाँ मन्दिरले मस्जिदको रिस गर्दैन भने गुम्बाले गिर्जाघरलाई गाली गर्दैन।
Voice751	नेपाल प्राकृतिक सुन्दरताले भरिपूर्ण देश हो।
Voice752	संसारका धेरै मानिसहरू निरन्तर पर्वतारोहण गरीरहन्छन।
Voice753	त्यसै गरी विश्वका कुनाकुनामा शान्तिको संदेश छरी अमर बन्न पुगेका शान्तिका अग्रदुत गौतम बुद्ध पनि मेरै देशका बासिन्दा हुन्।
Voice754	राधाले केही नबोलेर आफ्नो गोडा पानीमा हल्लाइरही ।
Voice755	न हो यो त्त्यस्तो अकस्मात्‌को मृत्यु जस्तो कि युद्धमा तातो गोली खाएर प्राण उडेको हुन्छ- सोच्दै नसोचेको गोली लाग्छ छातीमा, अनि त्यही अकस्मात्‌को आश्चर्यमा मान्छेको शरीर सेलाइहाल्छ ।
Voice756	अनुशासन भनेको नियमपालन हो।
Voice757	पर्वतारोहण एउटा साहसिक कार्य हो।
Voice758	समाजमा बसेपछि एक-अर्काको कदर गर्ने, सामाजिक नीतिनियमको पालना गर्ने, दुख परेको बेलामा एकले अर्कालाई सक्दो सहयोग गर्ने अनि कसैप्रति भेदभाव ।
Voice759	नेपालका प्रमुख समाचारपत्रहरूको बिक्री-वितरण निकै हुने गरेको पाइन्छ।
Voice760	भरखर यसो उँघेको मात्र थियो क्यारे, तर घडी कति छिटै बितेको ।
Voice761	सलाई बनाउने काठ, चन्दन, रबडको लस्सा, लह, मसला, बास इत्यादि वनबाट प्राप्त हुने गर्छ।
Voice762	अधिकांस नारीहरु (मेरा स्कुल कलेजका धेरै सहपाठी समेत)बिहे पश्चात अध्ययन स्थगित गरी आफ्नै बाटा आँफै बन्द गर्नमा तल्लिन भए/ छन् ।
Voice763	यही बमकाण्डभन्दा केही दिन पहिलेको कुरा ।
Voice764	अनुशासनमा नरहने मानिस लगामविनाको घोडाजस्तै हुन्छ, उसले जीवनमा केही गर्न सक्तैन।
Voice765	पर्वतारोहणले कुनै पनि चुचुरोमा पुग्ने व्यक्तिले जीवनमा आइपर्ने जस्तोसुकै समस्यासँग लड्न।
Voice766	त्यसैले म मेरो देश नेपाललाई ज्यादै माया गर्दछु र आफू नेपाली भई जन्मेकामा गौरव गर्दछु।
Voice767	कहाँ बाहिर ? यहाँ बाहिर, भित्र भन्ने छुट्टिएका दुई तत्त्व छन्‌ र : यहाँ त सबै क्रा बाहिरै बाहिर छ- उदाङ्ग ।
Voice768	यिनमा देश-विदेशका राजनैतिक गतिविधि खेलकुद, आर्थिक गतिविधि, कृषि र उद्योग-व्यवसाय तथा व्यापार, धर्म संस्कृति, इतिहास आदि हरेक विषयलाई ।
Voice769	र किशोरले स्वेच्छाले यो काम आफ्नो जिम्मामा लिएको थियो ।
Voice770	गत वैशाखसम्म तीन वटा एसी रहेकोमा अहिले थप गरिएको हो ।
Voice771	मीठो-मीठो खानेकुरो खान दिई आ आफ्ना दाजुभाइको दीर्घायु र निरोगिताको कामना गर्दछ।
Voice772	खस सम्प्रदाय अन्तर्गतका ठकुरी शाह वंशका राजा पृथ्वीनारायण शाहले गोर्खा जस्तो पहाडी राज्यका राजा भएर उपत्यकाका नेवारहरूको हृदय बुझ्नु, किरातहरूको आँत जित्नु कम चानचुने कुरो थिएन।
Voice773	पहाड चढ्दा व्यायाम पनि हुने भएकोले पर्वतारोहणहरूको शरीर स्वस्थ अनि तन्दुरुस्त बन्न पुग्दछ।
Voice774	अहिले पनि मृत्युका लागिको यो बृहत्‌ आयोजन समाप्त भैसकेको छैन- बाँकी रहेको कागजमा अफिसरहरूको दस्तखत पर्दै होला।
Voice775	यस्तो कार्य गरेर जसले पनि आफूलाई साहसीका रूपमा उभ्याउन सक्छ।
Voice776	म्याडम क्युरी, फलोरेन्स नाइटिङ्गेल, जुनको ताबेइ आदि यस्ता व्यक्तित्व हुन् जसले आफ्नो प्रतिभाको माध्यमबाट आफूलाई विश्वभर चिनाउन समर्थ भए र यिनी सबै नारी नै हुन् जसले शिक्षा पाएका थिए ।
Voice777	यहाँका यीनै विविधतामा समाजको जगमा नेपाली संस्कृति समाजको असल व्यवहार, मान्यता र भावना एउटै स्वरूप हो।
Voice778	आन्तरिक शान्ति र आनन्द मात्र पाउन सकिन्छ यदि हामी साधारण जीवनको नेतृत्व गर्दछौं र उच्च सोचाइले हामीलाई अरूको लागि राम्रो गर्न प्रेरित गर्दछ।
Voice779	तिनीहरू आफैमा भवदीय खर्च गर्नु भन्दा धैर्यतामा भोग्छन्।
Voice780	आफूले सक्ने काम गर्न म झन्झट मान्दैनथे ।
Voice781	देशमा कमी आएको छ।
Voice782	त्यसैले यहाँका मानिसले तिर्थाटनका लागि विदेशतिर गइरहनुपर्दैन, विभिन्न देवीदेवताका मन्दिर र तीर्थस्थल रहेको मेरो देश एक पुण्यभूमि हो।
Voice783	जसरी सनही, झुर्मा, मादल, ढोलक आदिबाट कुनै मनोरम ताल निस्किन्छ, त्यसरी नै हामीबाट नेपाली संस्कृति जन्मन्छ।
Voice784	नेपालमा पर्वतारोहण गर्नमा खास गरी सेर्पा जातिका मानिसहरू अग्र पङ्क्तिमा रहेका छन्।
Voice785	अनुशासनहीण विद्यार्थी उद्दण्डत, अराजकता, र विक्र्तिको बाटो तिर लाग्दछ,यस्ता विद्यार्थी भविष्यमा निकै पछुताउनुपर्दछ।
Voice786	हामी तुलसी, वर, पीपल आदिलाई पूजा गर्छौं।
Voice787	देशका नागरिकले गर्नुपर्ने कामहरू देशका विकासमा धेरै असर पार्ने गर्छन्।
Voice788	मा पूर्वपट्टि मुहडा गरेर बालुवाको राशिउपर कोल्टे पल्टेकी थिई ।
Voice789	पर्वतारोहण एउटा साहसिक कार्य हो।
Voice790	भोलिपल्ट त क समातिइहालेको थियो ।
Voice791	हामी नेपालीमा घमण्ड र स्वार्थ भन्ने भावना उठेको छैन।
Voice792	नेपाल आमालाई पिर परेको बेला हामी अगाडि बढ्छौ र देशलाई संकटबाट मुक्त गर्छौ।
Voice793	म आफूभन्दा ठूलालाई आदर गर्थे र उहाहरुलाई अह्राएको कम नअनकनाएका खुरुखुरु गरि दिन्थे ।
Voice794	बालुवामा गोडा राख्दा न्यानो अनुभव हुन्थ्यो र गोडा अलिक भासिन्थ्यो जसले कृतकती लागेको जस्तो हुन्थ्यो ।
Voice795	रूखहरू एक किनारामा- अमलतास, मौलश्री, शिरीप, काइयो.... फूलका रूखहरू-रुचिपूर्ण ढङ्गबाट लगाइएका छन्‌ ।
Voice796	सहज रुपमा भन्नुपर्दा नेपाली भनेको नेपालमा बस्ने नागरिक हो ।
Voice797	नेपाली भाषा नेपालको प्रमुख भाषा हो।
Voice798	कविता, कथा, उपन्यास, नाटक, निबन्ध आदि साहित्यिक हरेक विधामा नेपाली बहस मौलाएको छ।
Voice799	नेपालमा ठूला-ठूला जंगलहरु छन्।
Voice800	नेपाल हिमाल, पहाड र तराईको विविधताले भरिएको सुन्दर बगैँचा हो।
Voice801	रुसलाई समर्थन गर्नेले त्यसको परिणाम बेहोर्नुपर्ने चेतावनी दिएको बीबीसीले उल्लेख गरेको छ ।
Voice802	कैयन ठुला होटेल खचाखच भरेका होलान 'नारी हक हित' को आवज उठाउन र 'नारी दिवस' मनाउन न कि ।
Voice803	नेपाल वीरहरूको देश भनेर पनि चिनिन्छ।
Voice804	तिहार नेपालीहरूको ज्यादै रमाइलो र महत्त्वपूर्ण चाड हो।
Voice805	आफू अनुशासनमा रहने मानिसले नै अरुलाई पनि अनुशासनको पाठ पढाउन सक्छ।
Voice806	तिहार पाँचौं वा अन्तिम दिन भाइ-तिहारका रूपमा प्रसिद्ध छ।
Voice807	साँझदेखि नै सबै दिन केटीहरू घरघर गइ भैलो खेल्ने गर्दछन।
Voice808	यसमध्ये पन्ध्र लाख अघिल्लो आर्थिक वर्षको बक्यौता हो भने बाँकी चालु आर्थिक वर्षको हो ।
Voice809	नेपाल विभिन्न जातिहरूको संगम स्थल पनि हो।
Voice810	अनि राष्ट्रिय एकताको जग सशक्त बन्ने कुरा पृथ्वीनारायण शाहले नै सिकाएका छन्।
Voice811	यसै दिन दीपावलीको झिलिमिली सबैतिर परिने हुँदा नै तिहार चाडलाई ‘दीपावली’ समेत भन्ने गरिएको हो।
Voice812	यसैले जहाँ धार्मिक-संस्कृतिक दृष्टिले यो लक्ष्मीपूजा हाम्रो समाजमा महत्त्वपूर्ण रहेको छ त्यहीँ यही दिन नै हाम्रो साहित्यिक महोत्सव पनि मनाउनुपर्ने दिन बन्ने पुगेको छ।
Voice813	अनुशासनको पालना आफूभित्रैबाट हुनुपर्दछ, सबैले सचेत भई सामाजिक नीति-नियमका घेराभित्र रहेर काम गर्नु उचित हुन्छ।
Voice814	स्थानको कत्रो फैलाव नीलो आकाशको कत्रो विस्तीर्णता ।
Voice815	वास्तवमा भन्ने हो भने नेपाली भाषा सम्पूर्ण नेपालीहरूको आत्मा हो, ढुकढुकी हो।
Voice816	नेपाल अधिराज्यको संविधानले नेपाली भाषालाई राष्ट्रभाषाका रूपमा मान्यता दिएको छ।
Voice817	केही कुरा किनेपछि बिल लिने पनि हाम्रो कर्तव्य हो।
Voice818	मेरो घरमा त् झन् कसैलाई निन्द्रा पर्ने कुरै थिएन।
Voice819	अर्को दिन, त्यसपछि झन्‌ छ : श्वेतभैरबी अर्को गर्दागर्दै दिन बित्न थाले ।
Voice820	बेला-बेलामा भूक्षय भइरहने गर्छ।
Voice821	हुन्छन् र कतिपय समाजसेवीले बनेका हुन्छन।
Voice822	त्यसैले देश विकासका लागि शिक्षित नारीको खाँचो छ ।
Voice823	यहाँ त धेरै दिनदेखि पर्खिएको मृत्यु हो यो- झन्‌ दरबारबाट मृत्युदण्डको पुष्टि भएपछि- आज हुन्छ, भोलि हुन्छ भन्दै औंलामा दिन गन्दै मृत्युलाई पर्खेर बसेको ।
Voice824	तिनको सौन्दर्यले सबैको मन लोभित हुन्छ।
Voice825	अहिलेको युगमा पत्रपत्रिका नपढ्ने मानिसले केही पनि जानेको हुँदैन र उ देश-विदेशमा भइरहेका गतिविधिबारे अनभिज्ञ नै रहन्छ, ।
Voice826	यसले जीवनको विकासमा ठुलो भूमिका खेलेका हुन्छन।
Voice827	विदेशी विद्वान्हरूको चासोको विषय बन्नु नेपाली भाषाको ठूलै उपलब्धि हो।
Voice828	कतिपय त् यसलाई पेसाकै रूपमा पनि अँगालेको पाइन्छ।
Voice829	यसको महत्व बुझने मानिस नै अहिले अगाडि बढेका उदहारण सहित पाइन्छ।
Voice830	प्रिथिवी नारायण शाह, अमरसिंह थापा, भीमसेन थापा, राजेन्द्र लक्ष्मी आदिका योगदानले हाम्रो नेपालमा आजसम्म कसैले विजय हासिल गर्न सकेन।
Voice831	काशीको अन्नजलको हामीले घेरै सञ्चय गरेका रहेनछौं ।
Voice832	अठार सय छब्बिस मा काठमाडौं उपत्यकामाथि कब्जा जमाएपछि उनको विजय यात्राको अभियान र नेपाल एकीकरणको महोत्सवको एउटा अध्याय सम्पन्न गुरुतर दायित्व उनले निर्वाह गरे।
Voice833	मैले भनें- मेरो त एउटा मात्र नाउँ छ ।
Voice834	भ्याउ, काई, लेउ र पानीका लहराहरूले घेरिएर उभिएको थियो, पोखरीको मध्यमा एउटा कालो अग्राखको काठ।
Voice835	नारी जति पछाडी यो समस्याले हो।
Voice836	किशोर फेरि तस्वीर हेरेको जस्तै मनको चिसो आँखाले कलेजका साथीहरूलाई हेर्न थाल्थ्यो ।
Voice837	मेरो देश मेरो लागि गौरव हो किनकि यहाँ बार्हौ महिना बग्ने खोला-नाला छन् भने शान्तिको चिहन् गौतम बुद्धको जन्मस्थल हो।
Voice838	त्यस कारणले सुरुमा हामी नागरिकले आफ्नो कर्तव्य पुरा गर्नुपर्छ तब मात्र देश विकास भएन भने हामी सरकारलाई दोष दिन सक्छौ र यसको विरुद्धमा जान सक्छौं।
Voice839	पहाडको उच्च टाकुरामा पुगेर त्यहाँको सौन्दर्यमा डुब्न गर्न र आफ्नो कीर्ति राख्नका लागि मानिसहरू पर्वतारोहणमा मरिमेटेर लाग्छन्।
Voice840	यस दिन मीठा-मीठा खाने कुरा दिई माला लगाई सिँगारपटार गरी कुकुरको पूजा गरिन्छ।
Voice841	यस चाडमा खास गरी पटका पड्काएर अनि आतसबाजी गरेर मनोरञ्जन लिने चलन निकै बढ्दो छ।
Voice842	देश भन्ने बित्तिकै हामी सबैको साझा घर हो र यो घरलाई सुरक्षित गर्नु र यसको विकास गर्नु हाम्रो कर्तव्य हो।
Voice843	आफूले दुइटा फूल कानमा घुसारी; पूर्वपट्टिको डिलमा कदमको सानो रूख थियो ।
Voice844	निर्ममतासँग पृथ्वीलाई यसले आबद्‌ गरेको छ, त्यसमा गोडा राख्यो भने दुम्सीको काँडा उम्रेको जस्तो अङ्गअङ्गका तीक्ष्ण अङ्क्रले बर्बरताको सान्नानी : तीन परिचय दिन्छन्‌ ।
Voice845	हामी तुलसी, वर, पीपल आदिलाई पूजा गर्छौं।
Voice846	उनि नरभूपाल शाह र कौशल्यावातीका सन्तानका रूपमा जन्मेका हुन्।
Voice847	फाल्तू समयमा मात्र पत्रिका पढेर समयको सदुपयोग गर्ने मानिस नै बुद्धिमानी ठहरिन्छ, आधुनिक युगमा व्यक्ति, समाज तथा राष्ट्रको उन्नति हुनका ।
Voice848	पुस्तकालयमा विभिन्न छेत्रका किताबहरु हुन्छन।
Voice849	बेलुका उसले राधालाई भन्यो- हिँड जाउँ नदीतिर घुम्न ।
Voice850	म जन्मदा घरका सबै जना खुसीले ढङ्ग हुनुहुन्थ्यो रे! उहाँहरुका लागि म  घरको जगमगाउँदा बत्ती थिए, कुलको धरोहर थिए।
Voice851	साथैमा मेरो देश विश्वको शिखर सागरमाथाको देश हो,त्यसैले मेरो देशमा म धेरै गर्व गर्दछु।
Voice852	जस्तै – गाउँमा मानिसहरुलाई कुनै रोगको सिकार भयो भने अस्पताल नगएर धामी झाँक्री संग उपचार गराउन जानछन् ।
Voice853	अनुशासन' ;शासन' शब्दका अगिल्तिर 'अनु' उपसर्ग लागि बनेको शब्द हो।
Voice854	बाहिर, धेरै मानिसहरूको गोडाको आवाज खस्याकखुसुक सुन्यो, र कर्कश शब्दका साथ फलामे डन्डीमा सिक्री रगडिएको पनि ।
Voice855	बर्षमा एक पटक चिच्याएर 'दिवस' मनाउदैमा के फरक पर्छ नारीहरुको अध्यावधी पिछडित दयनिय कुचक्रित यथार्थमा?? ।
Voice856	सरकारले देशलाई हाम्रै पैसाले चलाउँछन्।
Voice857	दाजुभाइले पनि दिदी बहिनीलाई दक्षिणा तथा सौगातहरू दिई खुसी पार्छन।
Voice858	त्यसको बदलामा रुसले इरानलाई उपलब्ध गराउने सैन्य र प्राविधिक सहयोगले मध्यपूर्वका साझेदार र अन्तर्राष्ट्रिय सुरक्षामा जोखिम बढ्ने क्लिभर्लीले बताए ।
Voice860	मित्रहरु ! यि ति नारीहरु हुन् जसको हातमा प्रसस्त अवसर थियो ।
Voice861	चौथो अङ्ग पनि भनिन्छ, पत्रपत्रिकाहरू विविध सामग्रीले भरिएको पोका हुन्, राष्ट्रिय तथा अन्तरराष्ट्रिय क्षेत्रका हरेक पक्षलाई तिनीहरुले समेटेका हुन्छन्, ।
Voice862	हुने बिरुवाको चिल्लो पात भने झैँ पृथ्वीनारायण शाह सानेदेखि होनहार र प्रतिभाशाली व्यक्ति थिए।
Voice863	हामीले पुस्तकालयमा विभिन्न किताबहरु पाउन सक्छौ।
Voice864	तिनको सौन्दर्यले सबैको मन लोभित हुन्छ।
Voice865	वनबाट हामी नेपालीलाई थुप्रे फाइदाहरू छन्।
Voice866	सोझो बाटो छ त्यो, जसमा अघि- पछि केवल दुई दिशातिर मात्र आउन-जान सकिन्छ ।
Voice867	देश विकासका कार्यमा प्रत्येक युवा-युवतीले आ-आफ्नो क्षेत्रबाट सक्दो योगदान पुर्याइरहेका हुन्छन्।
Voice868	फूलबारीमा सयपत्री, गुलाफ, कमल, कमल,बेली, चमेली, जाई,जुही आदि हुन्छन्।
Voice869	त्यसरी राधासँग उसको प्रेम घनिष्ठतर हुँदै गएको थियो ।
Voice870	नेपालीहरुका अरु निकै पुराना चालचलनहरु देख्दा मख्ख पर्ने विदेशी पर्यटकहरु नेपाल भ्रमणको मीठो सम्झना आफ्नो हृदयको झोलामा भरेर लैजान्छन।
Voice871	यस अमेरमा स्वास्थको बारेमा थाहा हुँदैन र धेरै रोगका सिकार हुन सक्छ।
Voice872	त्यो काइथेहरूको गाउँ हो ।
Voice873	दसौं लाख युक्रेनीलाई ऊर्जा र अन्य अत्यावश्यकीय सेवाबाट वञ्चित गरिरहेको छ ।
Voice874	कडा नियम बनाए पनि यस आधानिक युगमा नराम्रो मानिसले गर्दा समाज पछि पर्छन्।
Voice875	निश्चय पनि ‘ हरियो वन नेपालको धन’ हो।
Voice876	रूपियाँ-पैसा अथवा सामान (नगद र जिन्सी) दाईजो हो भने दाईजो दिने प्रचलन दाईजो प्रथा हो।
Voice877	आजको युगमा यस्को धेरै नै महत्व दिइने गर्छन।
Voice878	शहरमा मलाई यो कुरा कसैले बताएनन्‌ कि मानिसको बोलाउने र न्वारनका भिन्न-भिन्न नाउँ हुन्छन्‌ ।
Voice879	वन अध्यात्म कालदेखि नै शान्तिको पुजारी रहेको छ।
Voice880	एकैदिनमा कति थोक मैले सिकें, यो गाउँमा आएर ।
Voice881	साम्राज्यवादीहरूका विषालु पाइतालालाई पवित्र उपत्यकाको आँगनमा पर्नबाट जोगाए।
Voice882	त्यही बिलको कारणले ती व्यापारीहरूलाई धेरै कम कर तिर्नुपर्छ।
Voice883	कोशी नदीको पश्चिम किनारमा उभिएर त्यहाँको दृश्यलाई हेर्दा रमाइलो लाग्यो ।
Voice884	पृथ्वीले एक निश्चित गतिमा सूर्यको परिक्रमा गरिरहेको हुन्छ र यसै आधारमा दिन र रातको प्रक्रिया चालू भाइरहन्छ।
Voice885	चिनीहरूले विश्वको कुनै एक कुनामा घटेको नयाँ-नयाँ घटनाको विवरण विश्वभरि नै फिँजाउने कम गर्दछ, पत्रपत्रिकाहरूले विभिन्न सामग्रीहरू छापेर देश ।
Voice886	वास्तवमा भन्ने हो भने नेपाली भाषा सम्पूर्ण नेपालीहरूको आत्मा हो, ढुकढुकी हो।
Voice887	यस्ता चाडहरूलाई हामीले आपसी मेलमिलाप बढाउन गरी मनाउनुपर्छ र यस्ता चाडहरू मनाई हामीले आफ्नो जीवनलाई पनि अझ सुन्दर पार्दै जानुपर्छ।
Voice888	ल नानी यसलाई गाउँ घुमाएर ल्याङ ।
Voice889	यस्ता नराम्रा कामहरू गर्दा कहिलेकहीँ एक-अर्कामा झाँगड पनि हुने गरेको स्थिति केही वर्ष यता देखिदैं छ।
Voice890	शून्य सडकका खामामा बत्ती घोरि  र भुइँतिर हेरिरहेका छन्‌ ।
Voice891	तर बोल्न बडो गाह्रो मानेको जस्तो गर्थी ।
Voice892	आफ्ना काखमारहेका असंख्य नदीनाला,हिमश्रीन्खालम, वनजंगल जस्ता प्राकृतिक सम्पत्ति र र पुराना जमानाक सुन्दर ।
Voice893	समाजमा हुने समस्यालाई सामाजिक समस्या भनिन्छ।
Voice894	अहिले समाजमा मानिसहरु सानालाई जातधर्ममा भेदभाव र हेप्ने गरछन् ।
Voice895	हाम्रा पुर्खाहरू आफ्नो स्वाभिमानमा अडेका थिए।
Voice896	नीलो आकाशको त कुरै भएन, त्यो त यति उचा छ, त्यो यति बिस्तृत छ र यति समान रूपले नीलो छ।
Voice897	सृष्टिमा सबभन्दा असहाय प्राणी त्यो कशकाय पीतवबर्ण बालक हो जो एक्कासि शहरबाट चुडिएर कनै गाउँमा रोपिन आइपुग्छ ।
Voice898	सधैं अरुकै मुख ताकेर हक पर्खेर होइन कि आँफैकम्मर कसुं ।
Voice899	आमा त केही नबुझेर अन्ध-वात्सल्यमा आँसु बगाइरहँदी होलिन्‌ ।
Voice900	ऋषि-मुनिहरू अध्यात्म शान्तिको लागि वन-जंगलमै गएर तपस्या गर्ने गरेको यथेष्ट प्रमाण धार्मिक ग्रन्थहरूमा पढ्न पाइन्छ।
Voice901	तिहारको चौथो दिनलाई गोरु-तिहारका रूपमा मनाइन्छ।
Voice902	उहाँहरुले प्रशस्त माया ममाथी खन्याउनुभएको थियो।
Voice903	र अनिवार्य भएमा मात्र अनिवार्य परिमाण प्रयोग होस्‌ ।
Voice904	साना अर्थात् तल्लो जतिको मानिसलाई काम पनि दिदैनन्।
Voice905	यहाँ अनेकौँ चाडपर्व, रीति रिवाज र प्रचलनहरू छन्।
Voice906	कार्तिक महिनाको शुल्क पक्षको दोस्रो दिन यो चाड पर्दछ।
Voice910	मानिसहरु पैसाका लागि धनी मान्छेहरुलाई लुटपाट गर्ने काम गर्छन ।
Voice911	एउटा घरपरिवारमा बाबु, आमा, छोरा, छोरी, दाजु, भाई आदि सबैले एक-अर्कालाई आदर र माया गर्नुपर्छ।
Voice912	त्यस दिनको यात्रामा स्मरणीय कुरा थिए- गोसाईंस्थान, नजरियाको पसल, पछवरिया धार।
Voice913	पालिकाबाट प्राप्त जानकारीअनुसार गत जेठदेखि हालसम्म इन्धन खर्चबापत मात्र चौंसट्ठी लाख छपन्न हजार रुपैयाँ भुक्तानी दिइएको हो ।
Voice914	नत्र ति साच्चैका अवसर बिहिन नारीहरुको नाम भजाएर सिमित नाकहरु ठड्याउनका लागि देखाइने यो गाइजात्रे ।
Voice915	पहिला भन्दा अहिले पुस्तकालय नेपालमा धेरै पाइन्छ।
Voice916	केवल जीवित जीवनमा विश्वास गर्नेहरूले मात्र सोच्न सक्छन् र जीवनमा महान कार्यहरू गर्न सक्छन्।
Voice917	प्रारम्भिक रूपमा भने इरानले रुसलाई ड्रोन उपलब्ध गराएको अस्वीकार गरेको थियो ।
Voice918	मलाई लाज पनि लाग्यो, केवल एउटा नाउँको अधिकारी भएकोले ।
Voice919	भान्सामा खान खान बस्दा मेरो दुवै आँखा चुल्होमा तताइराखेको दूधमा गोदिन्थें।
Voice920	आजको दिनमा समाजमा समस्याहरु बढ्दै गएको छ ।
Voice921	नेपाली अवस्थामा सुधार ल्याउने उद्देश्य लिई नेपाली राष्ट्रियताको बलियो जग बसालेका हुन्।
Voice922	तिमीसँग छुटियो कि गन्ध, शब्दहीन महाशून्यमा म निस्सासिन थाल्छु ।
Voice923	अखडाको द्वारमै एउटा ठुलो बाँसमा सेतो ध्वजा गाडेको थियो; त्यहीँनिर तुलसीको बोट उमारेको एउटा माटोको सानो चौतारो थियो ।
Voice924	कमिश्नरले फेरि सोधेका थिए- घरका मानिसहरूलाई केही भन्नु छ ।
Voice925	यो समय हामीले पहिचान गर्नुपर्दछ कि हामी आफैंको लागि बाँच्न र अरूलाई प्रभाव पार्न नसक्नु पर्छ।
Voice926	पछवरिया धारामा नुहायौं, एकछिन पौड्यौं ।
Voice927	उचित वातावरणका अभावमा आफ्नो देशमा उचित शिक्षा, रोजगार, काम र माम नपाउँदा कतिपय युवावर्ग बरालिन्छ र युवावर्ग बरालिँदै देश विकासको गीत ओरालो लाग्दछ।
Voice928	यदि तिनीहरुले नै यसलाई प्रयोग गरेनन् भने हाम्रो देशको विकास हुन सक्दैन।
Voice929	हामी नेपाली नेपाललाई अंग्रेजबाट मुक्त गराएर स्वच्छ बनाउने बिर योद्धा हो ।
Voice930	वन विनाशको कारणले आइपर्ने दुखलाई हरेक मानिसमा बुझाई अर्थात् जंगलको महत्त्वको जन चेतना जगाई सबैले वृक्षारोपण गर्ने।
Voice931	उसले भनी- होइन, तिमीलाई थाहा होइन होला ।
Voice932	मैले आजसम्मको दिनहरुमा कहिल्यै सुनेको छैन उपर्युक्त ठाउंमा पुरुष शब्द जोडीएको ।
Voice933	किशोरको तन्द्रा भङ्ग भयो; सोच्यो- उनीहरू आए ।
Voice934	अझै गाउहरुमा पुस्तकालयको धेरै नै कमी छ र अविकसित ठाउँ भनेको गाउँ नै हो।
Voice935	मेरो एक्लो हृदयको सारा विकलतामा ती स्नेहका धूमिल रेखा अड्ण मायामय भएर गए; म भरिएँ र पुनः आमाको पिठयूँलाई अंकमाल गर्न पुगें ।
Voice936	बताउँदै कर्बीले रुसले इरानसँग अस्त्रको विकास तथा तालिमका क्षेत्रमा सहकार्य गर्न खोजिरहेको दाबी गरे ।
Voice937	यो देहातमा बारम्बार सम्झना हुन्छ, कम्पनी बगैंचाको ।
Voice938	बजारमा ल्याइरहेका छन्, विज्ञापन वा प्रचार-प्रसार नभई कुनै पनि वस्तुले बजार पाउन सक्दैन, त्यसैले औद्योगिक उत्पादनहरूको प्रचार-प्रसार खुब गर्नुपर्छ, हाम्रो देशमा विभिन्न ।
Voice939	हामीहरु विभिन्न किसिमका मीठा-मीठा जिब्रे लट्याउने जंगली फलफूलहरू खानका लागि नै जंगल पस्थ्यौ।
Voice940	फूलबारीलाई सयपत्रीले मात्र सुन्दर बनाएको होइन र चमेलीले मात्र चम्केको पनि होइन।
Voice941	जस्तै गाजा,चरेस,हेरोइन आदि ।
Voice942	बाल्यकालमा बिहे गराउने चलनलाई वाल विवाह भनिन्छ।
Voice943	हामी नेपालीले एकतामा बसी देशमा परेको हरेक समस्यालाई समाधान गर्छौ।
Voice944	गोर्खाली सैनिकको मात्र कम भएपनि उनीहरूको हिम्मतले उनलाई कसैले हराउन सक्दैनथ्यो।
Voice945	नेपाल चाडलाई “यमपञ्चक” र “दीपावली’ का रूपमा पनि चिनिन्छ।
Voice946	उनीहरूको भौतिकवादी सम्पत्तिहरू देखाउँछन् कि तिनीहरूको सोच यो सीमित हुन्छ।
Voice947	यसले परिवारबाट उनीहरूलाई दूरीमा राख्छ र उनीहरूको व्यक्तिगत सम्बन्धलाई बाधा पुऱ्याउँछ र यो सबै मात्र तनावतर्फ जान्छ।
Voice948	तिनीहरू केवल आवश्यकताका चीजहरू किन्न र ध्यान दिन्छन् कि उनीहरूलाई आफ्नो कामको मार्गमा असल मनुष्य बन्न र तिनीहरूको सामान देखाउन नसक्ने फोकस गर्छन्।
Voice949	नेपालबाहिर बस्ने हिन्दू नेपालीहरू पनि यस चाडलाई उतिकै महत्त्व दिई मनाउँछन्।
Voice950	छोराको राम्रो हेरविचार गर्नू !
Voice951	नेपाल आमाका उर्वर कोखबाट समय-समयमा युगप्रवर्तक महानायकहरूको जन्म भएको छ र राष्ट्रियताको रथ हाँक्ने सारथिहरूको उदय भएको छ।
Voice952	खरिद गरिएको एसीको भुक्तानी बजार रेटभन्दा बढी गरिएको नगरपालिकाकै कर्मचारीहरू बताउँछन् ।
Voice953	सान्नानीले त्यसको खोटो नङले कोट्टाएर मलाई सुँघाई ।
Voice954	कोठाको अँध्यारो बाहिरको एउटा बल्बको प्रकाशले हटाइरहेको थियो ।
Voice955	बा भने आँसुलाई बलपूर्वक थाम्दै, नरिवलको हुक्कामा तमाखुमाथि तमाखु तानेर पिंढीमा एकहोरो टोलाएर बसिरहँदा होलान्‌ ।
Voice956	हाम्रो समाजमा धेरै समस्या हुने गर्छ ।
Voice957	हामीले बुझ्नैपर्छ कि खुशी केवल बाहिरका चीज भित्र र बाह्य चीजहरूमा मात्र पाउन सकिन्छ।
Voice958	पोखरीको उत्तरपषट्टिको डिलमा पहेँलो चम्पाको रूख थियो जसमा पहेँला फूल फुलेका थिए ।
Voice959	इन्जीनियर, वकिल, शिक्षक, प्राध्यापक, कृषक, लेखक, कलाकार, खेलाडी, कर्मचारी, पत्रकार, सैनिक, प्रहरी आदि जुनसुकै क्षेत्रमा सर्वप्रथम व्यक्तिको प्रवेश युवावस्थामा नै हुन्छ।
Voice960	यीनै पृथ्वीनारायण शाहको जन्म।
Voice961	राति सुत्ने कोठामा धेरै बेरसम्म सान्नानी पनि थिई ।
Voice962	उनले काठमाण्डौ उपत्यका जस्तो समृद्ध शाली, वैभवशाली राज्यमाथि हमला गर्न तगाराका रूपमा देखिएको नुवाकोटमाथि पहिलो आक्रमण गरे।
Voice963	चेलीबेटी बेचबेखन भनेको महिलालाई बेच्ने काम हो।
Voice964	येनकेन प्रकारले चारैतिर उम्रेका छन्‌ अव्यवस्थित किसिमबाट; भूप्रान्त कुनै छैन जसमा यो हरियो जाला नफैलिएको होस्‌ ।
Voice965	त्यसो हुनाले, चारैतिरबाट हरेस खाएर म आमाको पिठ्युमा टाँस्सिइरहेँ ।
Voice966	मीठो गन्ध ।
Voice967	तर युक्रेनमाथि आक्रमण हुनुअघि केही मात्रामा ड्रोन उपलब्ध गराएको स्वीकार गरेको थियो ।
Voice968	देश विकासको गहकिलो कुलतमा बरालिन नदिई उनीहरूलाई जोस र होसका साथ कम्मर कसेर बढ्नका लागि अनुकूल वातावरण बनाइदिएमा ।
Voice969	उसको हात आफ्नो हातमा लिएर- हामी दुवैले मिलेर आफ्नो छोरालाई राम्ररी हेरौंला, माया गरौंला, पढाउँला-लेखाउँला र ठूलो पारौंला ।
Voice970	बगैँचामा रङ्गीबिरङ्गी फूलहरू रहे झैँ यहाँ धेरै जात जाति छन्।
Voice971	पालिकामा चौँतिस मोटरसाइकल, स्कारपियो, कार, जेसिबी, वारुणयन्त्र एक/एक वटा तथा तीन वटा ट्रिपर र छ वटा ट्र्याक्टर छन् ।
Voice972	यो आधुनिक युगमा मानिस स्वन्त्रताका कारणले धेरै विकासहरू गरिरहेका छन्, मानिस खुल्ला पन्छी जस्ता छन्।
Voice973	त्यसपछि उनले क्रमशः: नुवाकोट लगायतका गोर्खाका छिमेकी राज्यहरू र पश्चिमतर्फका बाइसी र चौबीसी राज्यहरूमा ।
Voice974	दरबारमा राजा-रानी र अरू राजपरिवारका प्राणीहरू सुतेका थिए ।
Voice975	तर अनुशासनको बाटोमा हिँड्ने मानिसले जीवनमा सफलताको शिखर छुन सक्तछ।
Voice976	किशोरले फेरि आग्रह गरेको थियो- हो, नयाँ युगका अनुसार हामीले पनि हिंड्ने बानी गर्नुपर्छ राधा !
Voice977	हामीहरूले छोहोरा, मिश्री र नरिवल किन्यौं ।
Voice978	त्यसै गरी यस दिन गोरुको पूजा गर्ने चलन छ।
Voice979	पोखरी सानो थियो ।
Voice980	यदि छोरी भयो भने पेटमै मर्ने गरेको खबर आउछन्।
Voice981	मेरो दाइ पनि ढुक्कुरको शिकारमा यता आउनुभएको रहेछ, अनि पो, मुनरिया बाँच्न पाई ।
Voice982	कमिश्नरको बोली सुनियो कोठामा- अब बाहिर आउनुपर्यो  ।
Voice983	हामीहरू उभिया ठाउँनिर नदी यसो बाङ्गिएर पूर्वतिर लागेको छ्‌ ।
Voice984	राष्ट्रिय एकताका मर्मज्ञ एवम् ऐतिहासिक युगपुरुष पृथ्वीनारायण शाहले व्यष्टि-व्यष्टिका रूपमा रहेका राज्यलाई समष्टि रूप प्रदान गरी नेपाली राष्ट्रियताको बलियो जग बसालेका हुन्।
Voice985	युवाका लामा-लामा सबल भुजहरूले जुनसुकै चुनौती र अवरोधहरूलाई पनि धुजा-धुजा पार्न सक्छन्।
Voice986	हामीले ज्ञानले विश्वलाई परिवर्तन गर्न सक्छौ।
Voice987	हाम्रो समाजमा हत्याहिंसा,भेदभाव,दाइजो प्रथा,बाल बिवाह,लागु पदार्थ खाने आदि समस्याहरु हुन् ।
Voice988	कहिलेकाहीँ त् मलाई फेरी बाल्यावस्थामै फर्कू कि जस्तो लागेर आउँछ।
Voice989	सान्नानीलाई मैले आदर-स्नेह गर्ने कुनै बाटो पाइनँ, केवल बनारसदेखि बचाएर राखेको एक आना पैसा मेरो खल्तीमा थियो ।
Voice990	नेपाल अधिराज्य भरका हिन्दूहरूले यो चाड धूमधामसँग मनाउँछन्।
Voice991	छोरा पाउने आशामा महिलाले धेरै शिशु जन्माउँछन्।
Voice992	त्यसै गरी संस्कृतिक मूल्य र मान्यताका अनुसरण पनि सबैले गर्नुपर्दछ, राजनीतिक क्षेत्रमा त् झन् अनुशासन हुनु अपरिहार्य छ, ।
Voice993	उनीहरूको वीरता विश्वभरि फैलिएको छ।
Voice994	यस्तै धार पश्चिमपष्टि पनि छ- पछवरिया धार ।
Voice995	अन्धकारमा मानिसको लोक थाकेर मरेको- चिसो, जाडोले कठ्याङ्ग्रिएको ।
Voice996	युक्रेनको आरोप सुरुमा अस्वीकार गरेको भए पनि पछि इरानले रुस–युक्रेन युद्ध सुरु हुनुभन्दा कैयौं महिना अघि सीमित मात्रामा ड्रोनहरू पठाएको बताएको थियो ।
Voice997	उनको दृष्टि हमवात्खंड टुक्रा-टुक्रा परेर छिन्न-छिन्न भइरहेको दयनीय अवस्थातर्फ पुग्यो; उनको ध्यान ती स्वार्थी शासकहरूद्वारा भागबन्डा गरिएको।
Voice998	इरानले उपलब्ध गराएका ड्रोनहरूको प्रयोग गरेर रुसले युक्रेनी ऊर्जा केन्द्रमा आक्रमण गरेको छ।
Voice999	अनि स्वाभाविक स्थितिमा आएर उसले भनेकी थिई- तिमी कहिले- कहिले अनौठो व्यवहार गर्छौ, अनौठो कुरा गर्छौ ।
Voice1000	चुँडाल्न सक्छ र विकासको अभियानमा देशले लामो फड्को मार्न सक्छ।
Voice1001	महंगा लुगा र घरको चीजहरू किन्नुहोस् - के लागि? यो सबै एक राम्रो सामाजिक खडा स्थापित गर्न को लागी।
Voice1002	त्यसैले आज भोलि म घरीघरी आफ्नो बाल्यकालको मीठो सम्झना गरेर मन बहलाउने गर्दछु।
Voice1003	बा-आमा दुवैले बडो आग्रह गरे र भने- बुहारी घरैमा हामीसँग बस्छे, तँ पढ्न जालास्‌ ।
Voice1004	घर वरिपरि खेतमा धानका हरियो बुटाबुटिहरु हावाको हलुको स्पर्श पाएर मेरो आगमनको खुसीयालीमा छमछमती नाचिरहेको थिए।
Voice1005	हाम्रो गाउँको पूर्वपट्टिको सिमाना पनि यही नदी हो ।
Voice1006	यसले गाउँलाई तडका (बिजली) को डर हुँदैन- सान्नानीले मलाई बताई ।
Voice1007	पहिले-पहिलेको जस्तो भावनाले विभोर भएर होइन, एकदम अनुद्विग्न भएर; मानौं घरको दृश्य त्यो हेरिरहेको छ, तस्वीरहरूमा ।
Voice1008	हाम्रो देश नेपालमा दश % व्यापारीले पनि राम्ररी कर तिर्दैनन् र यसको परिणाम पनि हामीले नै भोग्ने गर्छौ।
Voice1009	अर्को दिन जाउँला त्यता..." चिलौनी धारबाट घर फर्किंदा मडरको पोखरी हेर्न गयौं ।
Voice1010	आँगनमा खेल्दा खेल्दै म गाउँका आफ्नै उमेरका साथीहरूसँग घुलमिल हुन थालेँ र मेरो क्रिडीस्थल फराकिलो हुँदै गयो।
Voice1011	उसको दुर्दमनीयतामा लज्जा र सङ्कोचले कुनै ठाउँ पाएको थिएन ।
Voice1012	आमा भन्नुहुन्छ- हट्न, के टाँस्सिरहेको ? जा बाहिर गएर खेल्‌ ।
Voice1013	मकवानपुरे राजाका सहयोगमा आएका विहारका नबाब मीर कासिमलाई मकवानपुरकै घुँडा टेकाइदिए।
Voice1014	उसको पानीसँग खेलिरहेको गोडा थामिएका थिए ।
Voice1015	राधा कत्रो भरोसा लिएर आइरहेकी थिई त्यस साँझमा ।
Voice2001	मेरो नाम श्रुति हो र म आज एउटा कथा सुनाउछु।
Voice2002	कथाको शिर्षक हो 'सर्कसको हात्ती'।
Voice2003	पोखरा कसरी पुग्ने होला।
Voice2004	आज मौसम बडो रमाइलो छ।
Voice2011	सबैको घरघरमा नेपाल समाचारपत्र आउथ्यौँ।
Voice2013	कलेज सकिएपछी उनिहरु पहिलोपल्ट भेट्न लागिरहेका थिए।
Voice2014	कस्तो होला त्यो भेट भन्ने प्रश्न सबैको मनमस्तिश्कमा थियो।
Voice2020	सबैले उनिहरुको ताली पिटेर स्वागत गरे।
Voice2021	बाकी सबैजना पनि बिस्तारै बिस्तारै आउँदै गरे।